station_id,latitude,longitude,fast,slow,count
1,22.716272,113.826349,5,5,10
2,22.678851,114.049721,20,0,20
3,22.509541,114.05851,0,8,8
4,22.60597,114.12211,0,6,6
5,22.732771,113.816951,0,55,55
6,22.706775,114.089928,19,0,19
7,22.563115,114.100803,0,15,15
8,22.730137,113.856308,0,12,12
9,22.724037,113.892424,10,19,29
10,22.6325,114.233941,0,24,24
11,22.534995,114.056606,0,5,5
12,22.524123,113.924843,0,12,12
13,22.689176,114.346185,0,18,18
14,22.54421,114.117286,0,2,2
15,22.647557,114.048078,20,0,20
16,22.478603,113.884043,0,12,12
17,22.727942,113.82565,0,11,11
18,22.533902,114.106792,0,18,18
19,22.588465,113.993017,4,22,26
20,22.506216,113.938953,0,9,9
21,22.540155,114.01892,2,4,6
22,22.726231,113.905719,12,0,12
23,22.547058,114.095443,0,3,3
24,22.731351,113.790987,0,10,10
25,22.583958,113.863746,0,10,10
26,22.625239,113.864174,9,32,41
27,22.71162,114.26997,0,14,14
28,22.7296,114.04726,0,26,26
29,22.653259,114.068186,40,0,40
30,22.690736,114.064322,0,8,8
31,22.520969,113.937401,0,12,12
32,22.593366,113.850167,0,12,12
33,22.612619,114.127152,0,6,6
34,22.584902,114.106376,0,6,6
35,22.516192,113.921492,4,43,47
36,22.7296,114.04726,12,0,12
37,22.625504,113.83804,14,4,18
38,22.728913,114.239907,0,22,22
39,22.720152,114.234986,0,3,3
40,22.586961,114.106492,70,16,86
41,22.54242,113.930472,0,6,6
42,22.7304,113.829739,0,24,24
43,22.690942,114.270954,0,24,24
44,22.617273,114.149992,0,34,34
45,22.520467,113.950235,11,42,53
46,22.492468,113.895002,0,8,8
47,22.513683,113.914678,0,64,64
48,22.583252,114.137044,0,12,12
49,22.509264,113.886103,0,36,36
50,22.710848,114.251442,0,12,12
51,22.727181,113.833452,0,4,4
52,22.611117,114.124909,0,6,6
53,22.684912,114.120736,0,6,6
54,22.571679,114.043632,0,4,4
55,22.64332,114.202977,0,6,6
56,22.633479,113.837596,0,12,12
57,22.536352,114.031562,0,6,6
58,22.563943,114.097808,0,6,6
59,22.602562,114.126209,0,12,12
60,22.72642,114.22194,0,24,24
61,22.710296,114.251553,0,24,24
62,22.542985,114.040452,0,5,5
63,22.540127,114.025093,0,5,5
64,22.536868,114.068445,0,6,6
65,22.587184,114.261394,0,8,8
66,22.53791,114.051237,0,6,6
67,22.528979,114.044673,0,4,4
68,22.48691,113.89237,0,12,12
69,22.721826,114.274033,0,4,4
70,22.64277,114.069669,0,12,12
71,22.491271,113.941996,0,16,16
72,22.603256,114.152602,0,3,3
73,22.573805,113.946385,0,47,47
74,22.519999,113.935913,0,6,6
75,22.640312,114.011249,0,12,12
76,22.569612,114.10666,0,6,6
77,22.514398,114.062954,0,6,6
78,22.564912,114.015799,0,2,2
79,22.520385,113.93734,0,6,6
80,22.72995,114.253211,0,6,6
81,22.544974,114.121593,0,3,3
82,22.646869,114.196529,0,4,4
83,22.52641,113.9273,0,10,10
84,22.582992,113.88751,0,2,2
85,22.525552,114.050752,0,14,14
86,22.560258,114.047872,0,12,12
87,22.58833,114.275801,0,8,8
88,22.536136,113.925693,0,1,1
89,22.525891,114.056066,0,3,3
90,22.582333,114.121266,0,2,2
91,22.525096,113.913398,0,3,3
92,22.598743,114.127957,0,8,8
93,22.624811,114.068004,0,3,3
94,22.553756,114.035875,0,3,3
95,22.554631,113.989703,0,10,10
96,22.614615,114.073996,0,36,36
97,22.534074,114.020878,0,14,14
98,22.516789,114.065332,0,3,3
99,22.633593,114.079601,0,5,5
100,22.545418,114.064502,0,3,3
101,22.547034,113.880254,0,6,6
102,22.562316,113.98208,0,4,4
103,22.73181,114.237207,0,8,8
104,22.571183,114.061546,0,2,2
105,22.621193,114.076978,0,38,38
106,22.546864,113.98015,0,3,3
107,22.71329,114.244243,0,24,24
108,22.727204,114.381555,0,6,6
109,22.539254,113.957255,0,30,30
110,22.548155,113.980305,0,15,15
111,22.554129,114.047403,0,3,3
112,22.549257,113.975541,0,5,5
113,22.557863,113.889517,0,2,2
114,22.649673,114.068171,0,9,9
115,22.732252,114.243,0,2,2
116,22.542474,114.020299,0,2,2
117,22.633709,114.039017,0,6,6
118,22.732382,113.813893,0,12,12
119,22.522986,114.066796,0,6,6
120,22.702681,114.400629,0,30,30
121,22.572622,113.849604,0,24,24
122,22.73241,113.81453,0,17,17
123,22.742158,113.837761,0,12,12
124,22.786988,113.903528,0,6,6
125,22.738526,113.991978,0,2,2
126,22.571362,114.089074,0,6,6
127,22.631632,114.033093,0,15,15
128,22.557794,113.893792,0,6,6
129,22.550947,113.973949,0,49,49
130,22.766308,113.875053,0,12,12
131,22.717114,114.264172,0,6,6
132,22.758483,114.365898,0,6,6
133,22.552946,113.898574,0,4,4
134,22.615941,113.861193,0,12,12
135,22.543693,114.074715,0,6,6
136,22.752069,113.938292,0,30,30
137,22.730822,113.892526,0,10,10
138,22.587633,114.124983,0,10,10
139,22.613655,113.864087,0,12,12
140,22.495288,113.93615,0,6,6
141,22.526743,113.927618,0,6,6
142,22.570783,113.915283,0,10,10
143,22.536825,113.917899,0,6,6
144,22.647367,114.022326,0,6,6
145,22.555893,113.908757,0,6,6
146,22.678093,114.313217,0,6,6
147,22.62068,113.863014,0,12,12
148,22.756606,114.36453,0,6,6
149,22.581157,114.141123,0,6,6
150,22.602561,114.050819,0,12,12
151,22.72683,114.249952,0,6,6
152,22.734659,114.261801,0,12,12
153,22.651259,114.065483,0,6,6
154,22.565009,113.871956,0,12,12
155,22.718273,113.908961,0,12,12
156,22.558608,114.173979,0,12,12
157,22.682578,114.082025,0,12,12
158,22.581447,113.890871,0,12,12
159,22.602804,114.102079,0,12,12
160,22.53956,114.10737,0,6,6
161,22.500391,113.941234,0,12,12
162,22.536754,114.122505,0,7,7
163,22.571628,114.069015,0,12,12
164,22.707807,114.39222,0,18,18
165,22.722722,113.833016,0,12,12
166,22.538175,114.096978,0,12,12
167,22.527761,113.92498,0,12,12
168,22.638053,114.089945,0,12,12
169,22.635962,114.026021,0,12,12
170,22.781845,113.84901,0,24,24
171,22.746707,114.026975,0,12,12
172,22.562855,114.126728,0,6,6
173,22.586413,114.121985,0,12,12
174,22.561254,114.142799,0,12,12
175,22.516626,114.044162,0,18,18
176,22.744593,114.255957,0,12,12
177,22.581459,114.142375,0,12,12
178,22.71214,114.240973,0,10,10
179,22.553258,114.234533,0,2,2
180,22.55776,113.953011,0,12,12
181,22.54122,113.991728,0,18,18
182,22.534891,114.010627,0,3,3
183,22.534961,114.011846,0,3,3
184,22.586323,113.945267,0,12,12
185,22.731419,114.373092,0,2,2
186,22.563354,114.178767,0,5,5
187,22.711257,114.238111,0,2,2
188,22.522153,114.027803,0,6,6
189,22.536271,113.925063,0,6,6
190,22.55458,114.044686,0,4,4
191,22.54147,114.12361,0,4,4
192,22.544127,113.92833,0,5,5
193,22.601094,114.029184,0,4,4
194,22.559026,113.889609,0,2,2
195,22.671026,113.839593,50,0,50
196,22.625504,113.83804,14,7,21
197,22.71162,114.26997,0,15,15
198,22.727942,113.82565,0,12,12
199,22.573805,113.946385,0,0,0
200,22.64277,114.069669,0,0,0
201,22.554631,113.989703,0,0,0
202,22.552946,113.898574,0,0,0
203,22.527761,113.92498,0,0,0
204,22.520467,113.950235,11,40,51
205,22.724037,113.892424,10,13,23
206,22.625239,113.864174,10,48,58
207,22.818918,113.87032,0,20,20
208,22.665786,114.295888,4,0,4
209,22.67147,113.899894,0,45,45
210,22.583094,113.862667,0,45,45
211,22.652676,114.121466,28,0,28
212,22.625239,113.864174,18,70,88
213,22.522617,114.057376,0,6,6
214,22.730104,114.25355,0,6,6
215,22.542353,113.927741,0,12,12
216,22.772981,114.303523,0,3,3
217,22.540999,113.950512,0,6,6
218,22.573471,113.96036,0,18,18
219,22.523645,113.913782,0,9,9
220,22.716825,113.795042,65,0,65
221,22.589264,114.240689,0,12,12
222,22.5652,114.127307,0,9,9
223,22.7372,114.25034,0,29,29
224,22.507381,114.04525,0,12,12
225,22.57208,114.0688,0,6,6
226,22.522602,113.924017,0,12,12
227,22.634085,114.053299,0,12,12
228,22.501092,113.916041,0,12,12
229,22.629094,114.024578,0,15,15
230,22.773128,113.814083,32,0,32
231,22.569964,113.904298,0,15,15
232,22.536693,114.058372,0,9,9
233,22.546389,114.13345,2,5,7
234,22.538942,114.066616,0,18,18
235,22.569999,113.89019,0,3,3
236,22.526476,113.941143,0,6,6
237,22.636727,114.41625,0,1,1
238,22.728282,113.82838,6,0,6
239,22.547542,114.105454,0,1,1
240,22.534718,114.032898,4,13,17
241,22.539155,113.95116,0,17,17
242,22.59221,114.51961,0,1,1
243,22.539278,114.105663,3,0,3
244,22.54804,114.14276,0,14,14
245,22.618137,114.110524,0,45,45
246,22.638026,114.057517,0,42,42
247,22.547743,114.142569,0,16,16
248,22.535621,113.920228,0,20,20
249,22.538899,113.966607,2,3,5
250,22.534352,114.061747,2,24,26
251,22.636284,114.185368,0,39,39
252,22.681619,114.26138,0,15,15
253,22.698506,113.998477,5,0,5
254,22.730242,114.251401,0,15,15
255,22.61672,114.149896,0,7,7
256,22.54205,114.064676,0,11,11
257,22.641906,114.124993,0,14,14
258,22.704524,114.236816,0,74,74
259,22.612226,114.138345,0,35,35
260,22.59737,113.994306,0,28,28
261,22.541244,114.119416,0,12,12
262,22.581689,113.875933,0,12,12
263,22.765804,113.859011,15,0,15
264,22.663999,113.922767,0,2,2
265,22.598652,114.046855,0,42,42
266,22.538421,113.975307,0,3,3
267,22.574182,114.112399,37,0,37
268,22.645317,114.192063,0,3,3
269,22.590117,114.126831,0,10,10
270,22.552116,114.098984,0,3,3
271,22.575963,114.124197,0,6,6
272,22.619093,114.150084,0,10,10
273,22.572176,114.129022,0,6,6
274,22.597764,114.121059,0,4,4
275,22.570852,114.12807,0,10,10
276,22.595678,114.107023,0,12,12
277,22.695784,114.145044,0,6,6
278,22.713865,114.216779,0,6,6
279,22.653106,114.025523,0,2,2
280,22.531533,113.922034,0,12,12
281,22.578516,113.955284,0,6,6
282,22.664678,114.021511,0,16,16
283,22.555719,113.874488,0,6,6
284,22.501733,113.916115,0,12,12
285,22.537978,113.977979,0,6,6
286,22.55585,114.18554,0,12,12
287,22.628281,114.111376,0,12,12
288,22.5029,113.943556,0,30,30
289,22.576101,114.125009,0,6,6
290,22.684776,114.045955,0,12,12
291,22.51343,114.057378,0,6,6
292,22.548991,114.110972,0,5,5
293,22.541976,114.04426,0,2,2
294,22.724611,114.274373,0,35,35
295,22.701285,114.228895,0,4,4
296,22.734357,114.245705,0,12,12
297,22.602994,114.126988,0,5,5
298,22.510686,114.060564,0,6,6
299,22.549527,114.122582,0,20,20
300,22.546215,114.065988,0,12,12
301,22.688209,114.262472,0,8,8
302,22.591628,113.890581,0,1,1
303,22.520958,114.061361,0,5,5
304,22.556332,114.018711,0,20,20
305,22.526818,113.917103,0,2,2
306,22.532225,114.067379,0,24,24
307,22.531407,114.054828,0,3,3
308,22.560531,114.058951,0,6,6
309,22.541225,114.124469,0,12,12
310,22.574122,114.134147,0,6,6
311,22.693393,114.11911,0,56,56
312,22.642885,114.011885,0,5,5
313,22.57373,113.908087,0,97,97
314,22.6072,114.115588,0,6,6
315,22.573709,113.904602,0,6,6
316,22.586028,113.88969,0,3,3
317,22.722642,114.217557,0,3,3
318,22.705945,114.205713,0,3,3
319,22.543427,113.936433,0,4,4
320,22.554189,113.971962,0,18,18
321,22.68423,114.262279,0,42,42
322,22.591356,114.056366,0,6,6
323,22.62188,114.028928,0,9,9
324,22.515384,113.928113,0,7,7
325,22.593816,114.130863,0,13,13
326,22.634546,114.057973,0,12,12
327,22.726848,114.23353,0,14,14
328,22.70288,114.229951,0,6,6
329,22.519667,113.93005,0,3,3
330,22.559756,113.912133,0,3,3
331,22.625121,114.127579,0,14,14
332,22.723858,114.254368,0,24,24
333,22.536226,113.992511,0,15,15
334,22.542943,114.064053,0,9,9
335,22.62907,114.033898,0,6,6
336,22.649516,114.06863,0,6,6
337,22.669333,114.124312,0,12,12
338,22.637257,114.015025,0,22,22
339,22.499616,113.941527,0,6,6
340,22.558266,113.975109,0,6,6
341,22.715112,114.242339,0,3,3
342,22.534038,114.024582,0,12,12
343,22.71301,113.83419,0,12,12
344,22.548124,114.149644,0,8,8
345,22.720903,114.234906,0,3,3
346,22.569623,113.95699,0,6,6
347,22.5584,114.066911,0,18,18
348,22.648985,114.208073,0,6,6
349,22.554576,114.243324,0,6,6
350,22.679867,114.334837,0,10,10
351,22.586662,114.278078,0,6,6
352,22.551563,113.928799,0,6,6
353,22.594494,114.131835,0,24,24
354,22.744663,114.253868,0,12,12
355,22.509203,113.923676,0,10,10
356,22.614925,113.867997,0,6,6
357,22.659641,114.077107,0,12,12
358,22.546315,113.925335,0,12,12
359,22.55732,113.954496,0,12,12
360,22.720276,114.237421,0,6,6
361,22.617125,113.866916,0,18,18
362,22.774995,113.871624,0,22,22
363,22.644829,114.050908,0,10,10
364,22.618444,113.866689,0,30,30
365,22.595693,113.843983,0,12,12
366,22.758483,114.365898,0,6,6
367,22.554026,114.035049,0,12,12
368,22.716711,114.069987,0,12,12
369,22.572823,113.875174,0,12,12
370,22.564666,114.168989,0,12,12
371,22.644616,114.079977,0,18,18
372,22.666678,114.026965,0,12,12
373,22.697647,114.086975,0,10,10
374,22.605448,113.846009,0,18,18
375,22.773076,114.313531,0,18,18
376,22.558819,113.938007,0,12,12
377,22.74508,114.041963,0,12,12
378,22.547691,114.011892,0,3,3
379,22.701614,114.221837,0,6,6
380,22.531382,114.022508,0,8,8
381,22.543329,114.044518,0,3,3
382,22.60078,114.02847,0,4,4
383,22.670815,114.003079,0,12,12
384,22.629092,114.013445,0,10,10
385,22.736966,114.028093,0,11,11
386,22.646863,114.207985,0,6,6
387,22.565746,114.126468,0,6,6
388,22.551252,114.131059,0,6,6
389,22.668921,114.313226,0,6,6
390,22.65641,114.077196,0,12,12
391,22.539617,114.099783,0,12,12
392,22.786451,113.905269,0,4,4
393,22.646368,114.0724,0,6,6
394,22.676867,114.228562,0,4,4
395,22.735538,113.787971,0,6,6
396,22.568873,114.123417,0,5,5
397,22.572926,113.864792,0,3,3
398,22.526506,114.043225,0,1,1
399,22.528602,113.921721,0,1,1
400,22.628952,114.031318,0,8,8
401,22.582067,114.134172,0,12,12
402,22.549061,113.930999,0,6,6
403,22.648847,114.188975,0,24,24
404,22.525082,114.067247,0,3,3
405,22.536691,114.016845,0,1,1
406,22.638026,114.057517,0,0,0
407,22.581689,113.875933,0,0,0
408,22.538421,113.975307,0,0,0
409,22.684776,114.045955,0,0,0
410,22.649516,114.06863,0,0,0
411,22.55732,113.954496,0,0,0
412,22.605448,113.846009,0,0,0
413,22.646368,114.0724,0,0,0
414,22.557731,113.935363,0,17,17
415,22.773713,114.412132,10,0,10
416,22.712034,114.141554,60,0,60
417,22.569964,113.904298,0,15,15
418,22.542201,113.932805,0,41,41
419,22.541075,114.110013,0,1,1
420,22.771198,113.829524,17,0,17
421,22.569964,113.904298,0,0,0
422,22.609673,114.124673,0,5,5
423,22.791784,113.8859,0,20,20
424,22.647778,113.824374,36,0,36
425,22.747357,114.241301,22,0,22
426,22.486376,113.92004,2,6,8
427,22.70959,114.207205,0,20,20
428,22.650908,114.188392,0,15,15
429,22.589541,114.260001,0,18,18
430,22.601238,113.855363,3,3,6
431,22.497377,113.916485,0,9,9
432,22.525249,114.043206,0,6,6
433,22.517165,113.928609,0,12,12
434,22.541494,113.96682,0,12,12
435,22.524463,114.055197,0,12,12
436,22.64817,114.190586,0,18,18
437,22.509056,114.048289,0,54,54
438,22.5338,114.108731,0,18,18
439,22.543209,114.120011,0,2,2
440,22.688481,114.076189,20,0,20
441,22.744423,114.032113,38,0,38
442,22.705926,114.377207,27,27,54
443,22.56679,113.856741,0,75,75
444,22.52227,114.058696,0,6,6
445,22.562833,114.243027,0,6,6
446,22.611468,114.104294,0,18,18
447,22.551652,114.123727,0,18,18
448,22.606571,113.936386,24,8,32
449,22.563403,113.896238,4,22,26
450,22.557102,113.951133,0,10,10
451,22.724682,113.92523,12,0,12
452,22.572429,113.959656,0,5,5
453,22.564051,113.850125,0,1,1
454,22.655593,114.125787,0,1,1
455,22.547222,114.011267,0,6,6
456,22.567324,114.127763,0,11,11
457,22.536866,114.119523,0,1,1
458,22.526032,113.919439,0,4,4
459,22.681487,114.067044,0,7,7
460,22.62382,114.108052,2,7,9
461,22.67241,113.92127,9,0,9
462,22.602767,114.030658,0,9,9
463,22.607534,114.156189,0,32,32
464,22.541075,114.110013,0,1,1
465,22.716239,114.241996,0,12,12
466,22.75174,114.385619,45,0,45
467,22.531023,114.031901,1,10,11
468,22.721307,114.302115,0,40,40
469,22.565812,113.968312,57,0,57
470,22.652169,114.03102,0,24,24
471,22.573339,113.891701,0,6,6
472,22.581056,113.953506,0,12,12
473,22.533659,114.12136,0,6,6
474,22.546632,114.135914,12,0,12
475,22.589083,113.877991,0,3,3
476,22.520741,114.064723,0,6,6
477,22.510362,114.06118,0,6,6
478,22.730965,114.229526,0,12,12
479,22.640714,114.200326,0,6,6
480,22.71042,114.216302,0,32,32
481,22.56704,114.127089,0,6,6
482,22.530012,114.085021,0,4,4
483,22.575802,113.858206,0,30,30
484,22.550011,113.955843,0,9,9
485,22.559604,114.129235,0,6,6
486,22.555516,114.107042,0,14,14
487,22.538029,114.103966,0,12,12
488,22.564904,113.883024,0,6,6
489,22.743436,113.804285,0,12,12
490,22.51441,113.928477,0,6,6
491,22.489926,113.888291,0,10,10
492,22.731323,113.823965,0,6,6
493,22.528143,113.928478,0,12,12
494,22.72471,114.248762,0,30,30
495,22.591237,114.132008,0,24,24
496,22.660839,114.032531,0,12,12
497,22.637101,113.841113,0,6,6
498,22.72561,114.290885,0,6,6
499,22.494419,113.936246,0,4,4
500,22.546129,114.143799,0,6,6
501,22.53834,114.113831,0,6,6
502,22.709709,114.241127,0,12,12
503,22.700105,114.220821,0,2,2
504,22.510992,113.93289,0,6,6
505,22.51783,114.061227,0,13,13
506,22.586272,114.242084,0,10,10
507,22.543339,114.112401,0,6,6
508,22.69469,114.026552,0,2,2
509,22.591408,113.991613,0,1,1
510,22.490043,113.914255,0,16,16
511,22.547744,114.120443,0,6,6
512,22.570833,114.057997,0,2,2
513,22.561908,113.980717,0,6,6
514,22.555199,114.188089,0,6,6
515,22.564527,113.899427,0,6,6
516,22.659092,113.816868,0,36,36
517,22.712068,114.240826,0,5,5
518,22.600645,114.028946,0,2,2
519,22.526188,114.045666,0,18,18
520,22.650054,114.02228,0,4,4
521,22.565889,114.015191,0,2,2
522,22.706233,114.20524,0,9,9
523,22.576558,113.923788,0,3,3
524,22.556623,114.189319,0,26,26
525,22.725356,114.232465,0,14,14
526,22.705507,114.205736,0,6,6
527,22.594104,114.110176,0,3,3
528,22.539877,113.974157,0,10,10
529,22.587126,113.879062,0,12,12
530,22.529525,113.912189,0,3,3
531,22.607446,114.156743,0,24,24
532,22.547402,113.975574,0,19,19
533,22.546126,113.978263,0,15,15
534,22.722642,114.217557,0,4,4
535,22.553301,114.127148,0,6,6
536,22.563612,114.057748,0,8,8
537,22.502577,113.939339,0,12,12
538,22.734709,113.814955,0,12,12
539,22.538405,113.976669,0,6,6
540,22.553181,114.092926,0,6,6
541,22.537699,114.119255,0,20,20
542,22.513671,113.909934,0,4,4
543,22.693619,114.059287,0,6,6
544,22.568642,113.857879,0,6,6
545,22.567738,114.123278,0,3,3
546,22.585337,114.121943,0,4,4
547,22.607401,114.158691,0,16,16
548,22.608236,114.158199,0,70,70
549,22.626514,114.103848,0,70,70
550,22.768278,114.279828,6,24,30
551,22.497786,113.941249,0,6,6
552,22.645133,114.073176,0,12,12
553,22.530307,114.066648,0,10,10
554,22.629449,114.040526,0,36,36
555,22.591606,114.305614,0,16,16
556,22.649804,114.113351,0,6,6
557,22.550144,113.955618,0,6,6
558,22.615362,113.862252,0,12,12
559,22.523014,114.070788,0,6,6
560,22.71966,114.233074,0,6,6
561,22.532132,114.067055,0,6,6
562,22.589652,114.254868,0,12,12
563,22.615153,113.864019,0,12,12
564,22.555031,114.120024,0,4,4
565,22.614081,114.140972,0,6,6
566,22.631017,114.414742,0,9,9
567,22.576912,114.126979,0,6,6
568,22.584809,114.138043,0,6,6
569,22.544005,114.054052,0,26,26
570,22.584995,114.26076,0,12,12
571,22.64256,114.010987,0,6,6
572,22.558479,114.036602,0,10,10
573,22.562702,114.014566,0,12,12
574,22.614744,113.867697,0,6,6
575,22.509882,114.483345,0,12,12
576,22.722822,114.221625,0,6,6
577,22.545685,113.927038,0,6,6
578,22.717825,113.890783,0,12,12
579,22.554647,114.046263,0,5,5
580,22.512573,113.920759,0,12,12
581,22.620756,114.071955,0,12,12
582,22.624989,114.040065,0,12,12
583,22.73879,114.027927,0,12,12
584,22.724255,114.246943,0,12,12
585,22.543494,114.046011,0,12,12
586,22.550542,114.105314,0,18,18
587,22.560892,114.057964,0,8,8
588,22.637693,113.842376,0,12,12
589,22.558018,113.956389,0,10,10
590,22.637125,114.187974,0,14,14
591,22.737962,113.991039,0,12,12
592,22.721434,114.237407,0,7,7
593,22.563638,114.245004,0,12,12
594,22.736262,113.991027,0,12,12
595,22.548052,114.152113,0,2,2
596,22.548647,114.011055,0,12,12
597,22.551099,114.123166,0,6,6
598,22.720502,114.254096,0,12,12
599,22.550542,114.105314,0,12,12
600,22.601834,114.481163,0,12,12
601,22.748871,114.048948,0,12,12
602,22.766764,113.903102,0,20,20
603,22.544345,114.094768,0,12,12
604,22.569345,113.905534,0,8,8
605,22.530845,113.91205,0,3,3
606,22.724483,114.233304,0,4,4
607,22.515563,114.06339,0,6,6
608,22.552808,114.043552,0,6,6
609,22.644334,114.019752,0,12,12
610,22.538613,114.051136,0,6,6
611,22.533986,114.106953,0,36,36
612,22.681643,114.120259,12,0,12
613,22.564904,113.883024,0,0,0
614,22.510992,113.93289,0,0,0
615,22.528143,113.928478,0,0,0
616,22.539877,113.974157,0,0,0
617,22.645133,114.073176,0,0,0
618,22.693836,113.92368,0,20,20
619,22.627451,113.936525,8,11,19
620,22.602767,114.030658,0,10,10
621,22.768278,114.279828,0,0,0
622,22.703489,113.817222,10,0,10
623,22.586088,113.858087,6,35,41
624,22.712706,114.142112,20,0,20
625,22.7236,113.892155,0,6,6
626,22.667231,114.288969,20,0,20
627,22.718044,113.930055,10,0,10
628,22.690517,114.074402,20,0,20
629,22.653983,114.204482,0,16,16
630,22.563403,113.896238,0,0,0
631,22.526032,113.919439,0,0,0
632,22.606571,113.936386,0,0,0
633,22.541075,114.110013,0,0,0
634,22.564051,113.850125,0,0,0
635,22.716747,113.794798,72,0,72
636,22.7206,113.842774,6,0,6
637,22.591116,114.258971,0,18,18
638,22.734516,114.245248,0,24,24
639,22.630207,113.937247,2,9,11
640,22.695303,114.056089,0,30,30
641,22.53293,113.942789,0,13,13
642,22.721551,114.288835,0,6,6
643,22.66961,114.225191,0,5,5
644,22.768991,114.302313,0,3,3
645,22.695699,114.387924,6,1,7
646,22.518639,114.035381,0,12,12
647,22.560924,113.984651,0,12,12
648,22.559994,114.180614,0,12,12
649,22.505631,113.92015,0,24,24
650,22.685913,114.339263,0,18,18
651,22.781079,113.889611,6,0,6
652,22.541289,113.925772,0,9,9
653,22.613261,114.103439,0,27,27
654,22.524621,113.92571,0,16,16
655,22.53626,114.109366,0,10,10
656,22.55117,113.98878,2,8,10
657,22.53069,114.069428,0,4,4
658,22.707601,114.345871,0,32,32
659,22.492013,113.913198,0,12,12
660,22.579,114.11661,0,42,42
661,22.629165,114.08633,54,0,54
662,22.771198,113.829524,17,0,17
663,22.609198,113.847282,6,0,6
664,22.562281,113.854733,2,2,4
665,22.641304,114.031654,1,4,5
666,22.728948,113.828681,0,1,1
667,22.640178,114.037155,0,12,12
668,22.543519,113.9337,0,9,9
669,22.554441,113.920625,0,46,46
670,22.537369,113.922874,0,14,14
671,22.478934,113.915138,0,10,10
672,22.511655,113.925598,0,78,78
673,22.768778,113.887207,6,0,6
674,22.717804,114.241036,0,2,2
675,22.543062,113.952908,4,6,10
676,22.704937,114.095187,26,0,26
677,22.559771,114.107833,0,6,6
678,22.612674,114.162049,40,0,40
679,22.520885,113.927137,0,15,15
680,22.636479,113.841443,0,3,3
681,22.747975,113.819553,0,12,12
682,22.5525,114.10187,0,3,3
683,22.551752,114.124529,0,6,6
684,22.570995,114.067942,0,6,6
685,22.510845,113.926702,0,6,6
686,22.539208,114.083568,0,3,3
687,22.508678,113.886514,0,24,24
688,22.563732,113.881923,0,6,6
689,22.549004,113.932639,0,5,5
690,22.575073,113.860693,0,6,6
691,22.733191,113.825795,0,8,8
692,22.561121,114.067192,0,6,6
693,22.540195,114.092776,0,6,6
694,22.566256,114.124387,0,6,6
695,22.580591,114.138995,0,8,8
696,22.61371,114.112,0,6,6
697,22.516591,113.912084,0,12,12
698,22.510958,113.886698,0,12,12
699,22.773103,113.85828,0,12,12
700,22.560536,114.055075,0,6,6
701,22.510984,113.932879,0,6,6
702,22.568052,114.045986,0,4,4
703,22.610517,114.126986,0,2,2
704,22.574039,114.113921,0,11,11
705,22.59678,114.121773,0,6,6
706,22.524452,114.042219,0,2,2
707,22.732779,113.986739,0,30,30
708,22.551492,114.130265,0,6,6
709,22.5775,114.125373,0,6,6
710,22.564382,114.015239,0,2,2
711,22.732276,114.373693,0,3,3
712,22.728199,113.796557,0,28,28
713,22.563596,114.17848,0,5,5
714,22.540048,114.04409,0,5,5
715,22.492329,113.943023,0,12,12
716,22.54516,114.013349,0,4,4
717,22.592395,113.885401,0,2,2
718,22.595835,114.123217,0,3,3
719,22.721362,114.236244,0,1,1
720,22.513999,114.061743,0,3,3
721,22.564233,114.016306,0,2,2
722,22.605827,113.85186,0,3,3
723,22.55946,113.956762,0,21,21
724,22.593201,114.060064,0,6,6
725,22.723864,114.231814,0,16,16
726,22.617513,114.044555,0,3,3
727,22.554526,113.995834,0,10,10
728,22.596638,114.124449,0,2,2
729,22.561905,114.01606,0,13,13
730,22.546292,114.040676,0,1,1
731,22.653237,114.021369,0,3,3
732,22.512402,113.912663,0,9,9
733,22.550918,114.039323,0,5,5
734,22.625688,114.064988,0,16,16
735,22.583437,113.888424,0,4,4
736,22.479532,113.914551,0,15,15
737,22.722642,114.217557,0,3,3
738,22.526183,113.952036,0,6,6
739,22.528957,113.914417,0,10,10
740,22.55104,114.125083,0,7,7
741,22.732458,114.241974,0,2,2
742,22.52505,113.915755,0,4,4
743,22.549004,113.967071,0,18,18
744,22.644839,114.182373,0,36,36
745,22.743456,114.23706,0,36,36
746,22.538885,114.067448,0,15,15
747,22.599271,114.043972,0,10,10
748,22.542459,113.988951,0,24,24
749,22.511462,113.915536,0,12,12
750,22.511467,113.914747,0,24,24
751,22.646735,114.072074,0,10,10
752,22.539426,113.978029,0,6,6
753,22.537806,114.020148,0,3,3
754,22.740847,114.251684,0,8,8
755,22.634935,114.020065,0,36,36
756,22.714658,114.267006,0,6,6
757,22.540144,114.096934,0,5,5
758,22.606902,114.15891,0,36,36
759,22.705786,114.342441,0,9,9
760,22.530039,114.052006,0,3,3
761,22.543127,114.068966,0,12,12
762,22.611487,114.114584,0,4,4
763,22.588544,114.251243,0,12,12
764,22.571743,114.128481,0,10,10
765,22.723424,113.893869,0,6,6
766,22.635842,114.009274,0,6,6
767,22.656206,114.028156,0,12,12
768,22.617917,114.14498,0,6,6
769,22.566896,114.111247,0,6,6
770,22.557759,114.170915,0,12,12
771,22.721364,114.381276,0,6,6
772,22.72073,114.268881,0,6,6
773,22.546141,114.050996,0,34,34
774,22.537428,114.00096,0,12,12
775,22.561208,114.037088,0,4,4
776,22.612196,113.861156,0,12,12
777,22.595637,114.114015,0,10,10
778,22.606366,114.117133,0,34,34
779,22.502636,113.896128,0,12,12
780,22.543973,114.05091,0,6,6
781,22.546579,114.231924,0,10,10
782,22.55545,114.11051,0,12,12
783,22.731123,114.038834,0,12,12
784,22.772703,113.857964,0,9,9
785,22.713825,114.252148,0,12,12
786,22.562021,114.142001,0,10,10
787,22.512993,113.930231,0,12,12
788,22.556261,114.036508,0,12,12
789,22.753096,114.276947,0,18,18
790,22.566438,114.173782,0,12,12
791,22.619699,114.156346,0,28,28
792,22.581017,113.971319,0,10,10
793,22.574419,114.116405,0,12,12
794,22.548341,114.012055,0,12,12
795,22.577021,113.925073,0,12,12
796,22.512933,113.930998,0,12,12
797,22.696234,114.143019,0,28,28
798,22.632514,114.031998,0,36,36
799,22.542457,114.04085,0,3,3
800,22.607652,114.063068,0,12,12
801,22.635972,114.028902,0,4,4
802,22.701179,114.220821,0,3,3
803,22.684215,114.26201,0,22,22
804,22.594572,114.124796,0,4,4
805,22.61084,113.857057,0,16,16
806,22.534794,114.029918,0,2,2
807,22.554058,114.035533,0,2,2
808,22.559228,113.878549,0,12,12
809,22.71482,113.828819,0,4,4
810,22.575867,114.086961,0,3,3
811,22.516533,114.053323,0,3,3
812,22.554668,114.043575,0,6,6
813,22.55878,113.972534,0,20,20
814,22.567454,113.886352,0,2,2
815,22.594547,113.911116,0,6,6
816,22.500517,113.941449,0,3,3
817,22.549992,114.1275,0,6,6
818,22.55928,114.120186,0,9,9
819,22.558061,114.11624,0,2,2
820,22.781237,113.889665,6,0,6
821,22.540195,114.092776,0,0,0
822,22.510984,113.932879,0,0,0
823,22.554526,113.995834,0,0,0
824,22.644839,114.182373,0,0,0
825,22.546174,114.082419,0,9,9
826,22.695413,114.224867,0,8,8
827,22.695699,114.387924,0,1,1
828,22.543062,113.952908,0,0,0
829,22.572866,113.913595,7,2,9
830,22.764638,114.301752,38,0,38
831,22.627436,114.035599,2,4,6
832,22.585807,113.85835,0,13,13
833,22.50086,113.888291,0,30,30
834,22.610245,114.121234,12,2,14
835,22.696603,113.999267,0,10,10
836,22.585276,113.868511,0,6,6
837,22.707336,114.102541,12,0,12
838,22.572331,113.913753,0,10,10
839,22.600407,113.835707,0,14,14
840,22.764638,114.301752,38,0,38
841,22.544466,113.935979,0,76,76
842,22.526032,113.919439,0,4,4
843,22.771198,113.829524,0,0,0
844,22.729042,114.268515,0,18,18
845,22.693449,113.788126,5,6,11
846,22.781304,113.864701,20,0,20
847,22.725119,114.236212,0,6,6
848,22.671338,114.058219,0,15,15
849,22.637485,113.839995,0,15,15
850,22.55507,113.876102,0,39,39
851,22.553083,114.228405,0,9,9
852,22.534831,113.952245,0,17,17
853,22.505599,114.061126,0,9,9
854,22.682075,114.262705,0,45,45
855,22.606709,113.841307,4,7,11
856,22.524964,113.920836,0,6,6
857,22.724006,113.892075,10,0,10
858,22.533622,113.940834,0,66,66
859,22.721584,114.230944,0,18,18
860,22.563358,114.060321,0,6,6
861,22.534182,113.946449,0,10,10
862,22.566642,113.855278,0,30,30
863,22.635491,114.004064,4,22,26
864,22.540473,113.939987,0,18,18
865,22.718709,114.237276,0,36,36
866,22.596409,114.478137,0,7,7
867,22.56086,113.941083,18,14,32
868,22.62328,114.42795,0,1,1
869,22.602124,113.847831,6,0,6
870,22.612233,113.856092,0,12,12
871,22.682783,113.831056,0,8,8
872,22.732245,113.816864,2,36,38
873,22.605939,114.158081,0,24,24
874,22.526563,113.941112,0,17,17
875,22.717609,113.899904,4,9,13
876,22.567994,114.062534,0,5,5
877,22.573024,113.924005,0,6,6
878,22.5875,113.886492,0,31,31
879,22.611936,113.855303,0,13,13
880,22.689934,114.325699,0,23,23
881,22.520186,114.053344,0,18,18
882,22.689256,114.068553,0,3,3
883,22.585192,113.863634,15,0,15
884,22.565126,114.069183,0,40,40
885,22.551029,114.026501,0,5,5
886,22.558244,113.974223,0,9,9
887,22.757591,113.918816,53,0,53
888,22.69148,114.068679,0,7,7
889,22.581101,114.119618,0,20,20
890,22.517507,114.05142,0,6,6
891,22.769367,113.876198,0,6,6
892,22.54308,114.135713,0,8,8
893,22.714486,114.240894,0,3,3
894,22.763476,113.824877,30,0,30
895,22.623946,114.128721,0,12,12
896,22.536434,114.102366,0,3,3
897,22.53531,113.983395,0,12,12
898,22.648621,114.117167,0,12,12
899,22.532607,114.085976,0,24,24
900,22.658614,114.207224,0,3,3
901,22.650269,114.114883,0,34,34
902,22.707894,114.051028,0,7,7
903,22.720146,114.304213,0,48,48
904,22.632498,114.01144,0,3,3
905,22.53786,114.127665,0,9,9
906,22.728625,114.249002,0,10,10
907,22.731066,114.231861,0,11,11
908,22.537417,114.001244,0,6,6
909,22.569406,113.959641,0,6,6
910,22.599074,114.314467,0,6,6
911,22.542135,114.02169,0,12,12
912,22.732951,113.829897,0,17,17
913,22.547337,114.128365,0,6,6
914,22.583731,113.876688,0,12,12
915,22.506186,113.917778,0,12,12
916,22.577473,114.126081,0,6,6
917,22.530288,114.046228,0,24,24
918,22.494167,113.931405,0,12,12
919,22.541298,114.131896,0,12,12
920,22.526772,114.03358,0,6,6
921,22.580323,113.957941,0,22,22
922,22.567075,114.041934,0,8,8
923,22.546067,114.104966,0,6,6
924,22.515714,113.917684,0,6,6
925,22.536059,113.996567,0,6,6
926,22.712304,114.021644,0,35,35
927,22.50714,114.058399,0,30,30
928,22.549756,114.122204,0,6,6
929,22.535108,114.012555,0,8,8
930,22.56622,114.044954,0,3,3
931,22.722649,114.225042,0,6,6
932,22.550857,113.900938,0,4,4
933,22.541043,114.122269,0,12,12
934,22.56483,114.058643,0,4,4
935,22.575448,113.864171,0,14,14
936,22.618235,114.14036,0,6,6
937,22.572305,113.958062,0,2,2
938,22.542674,114.108075,0,6,6
939,22.51783,114.061227,0,16,16
940,22.554933,114.031016,0,6,6
941,22.515938,113.923943,0,2,2
942,22.538141,113.984652,0,18,18
943,22.659094,114.075174,0,10,10
944,22.556572,113.985759,0,6,6
945,22.553755,113.878191,0,36,36
946,22.700087,114.138337,0,5,5
947,22.54725,114.016155,0,6,6
948,22.590705,113.991765,0,2,2
949,22.72115,114.230618,0,3,3
950,22.672775,114.048288,0,5,5
951,22.562698,114.17798,0,4,4
952,22.529337,113.926594,0,1,1
953,22.57092,113.855391,0,26,26
954,22.527224,114.071156,0,2,2
955,22.600709,114.305921,0,15,15
956,22.564159,114.015963,0,2,2
957,22.526382,113.918138,0,2,2
958,22.55933,113.955276,0,15,15
959,22.545902,114.046892,0,3,3
960,22.749667,114.21939,0,38,38
961,22.52366,114.070456,0,2,2
962,22.562918,113.891552,0,6,6
963,22.526399,113.965366,0,18,18
964,22.603132,113.852514,0,6,6
965,22.651583,114.188232,0,14,14
966,22.522678,113.919662,0,3,3
967,22.573103,113.906083,0,11,11
968,22.55822,113.889454,0,1,1
969,22.649522,114.210868,0,18,18
970,22.583217,113.883397,0,3,3
971,22.547524,114.044698,0,2,2
972,22.732235,114.244616,0,3,3
973,22.553528,114.237844,0,4,4
974,22.606186,114.156786,0,24,24
975,22.722642,114.217557,0,2,2
976,22.570021,114.061634,0,3,3
977,22.537004,113.99479,0,11,11
978,22.541663,114.013882,0,3,3
979,22.61162,114.068972,0,21,21
980,22.654276,114.082759,0,6,6
981,22.624386,114.103548,0,24,24
982,22.688085,114.069259,0,106,106
983,22.568423,114.093266,0,6,6
984,22.606214,113.841816,0,6,6
985,22.553619,114.029755,0,6,6
986,22.613987,113.864927,0,6,6
987,22.625045,114.101209,0,102,102
988,22.521541,114.039729,0,6,6
989,22.541958,113.990345,0,6,6
990,22.53963,114.112139,0,12,12
991,22.555374,114.120191,0,4,4
992,22.730438,114.296664,0,6,6
993,22.696008,114.124433,0,6,6
994,22.765474,113.923273,0,18,18
995,22.570004,114.045739,0,18,18
996,22.749335,114.277985,0,12,12
997,22.615196,113.859057,0,24,24
998,22.553756,114.152076,0,6,6
999,22.553153,113.94009,0,10,10
1000,22.548674,114.084059,0,10,10
1001,22.529224,113.914835,0,12,12
1002,22.55508,114.042651,0,12,12
1003,22.700939,114.233711,0,12,12
1004,22.545333,113.977615,0,18,18
1005,22.565063,113.867031,0,12,12
1006,22.730364,114.244475,0,3,3
1007,22.726903,113.84363,0,8,8
1008,22.711901,114.256974,0,12,12
1009,22.589366,113.992075,0,12,12
1010,22.53311,114.05407,0,8,8
1011,22.540382,114.129981,0,12,12
1012,22.70446,114.220433,0,6,6
1013,22.567154,114.076987,0,12,12
1014,22.581663,113.890974,0,12,12
1015,22.541007,114.137379,0,10,10
1016,22.635825,114.089966,0,12,12
1017,22.745204,114.04302,0,12,12
1018,22.476659,113.887819,0,14,14
1019,22.65176,114.065613,0,18,18
1020,22.722914,114.054777,0,10,10
1021,22.74508,114.041963,0,18,18
1022,22.607966,114.116112,0,9,9
1023,22.547644,114.01191,0,2,2
1024,22.51877,113.943587,0,5,5
1025,22.630591,114.086832,0,12,12
1026,22.536822,114.078254,0,3,3
1027,22.534152,113.978043,0,4,4
1028,22.528082,114.052162,0,13,13
1029,22.546775,114.047172,0,2,2
1030,22.531611,113.995997,0,6,6
1031,22.529467,114.02222,0,14,14
1032,22.644119,114.069044,0,10,10
1033,22.526685,114.051,0,6,6
1034,22.630556,114.036247,0,5,5
1035,22.576519,113.859834,0,12,12
1036,22.560629,114.175273,0,2,2
1037,22.533704,114.092513,0,3,3
1038,22.503192,113.940103,0,14,14
1039,22.547198,114.066948,0,8,8
1040,22.549568,114.042222,0,3,3
1041,22.592606,114.126261,0,4,4
1042,22.524411,114.054089,0,6,6
1043,22.56086,113.941083,18,12,30
1044,22.781156,113.86469,20,0,20
1045,22.558244,113.974223,0,0,0
1046,22.515714,113.917684,0,0,0
1047,22.649522,114.210868,0,0,0
1048,22.722914,114.054777,0,0,0
1049,22.476659,113.887819,0,0,0
1050,22.644119,114.069044,0,0,0
1051,22.630591,114.086832,0,0,0
1052,22.682783,113.831056,0,1,1
1053,22.561369,113.941856,18,14,32
1054,22.526563,113.941112,0,16,16
1055,22.744758,114.40559,4,0,4
1056,22.682783,113.831056,0,22,22
1057,22.682783,113.831056,0,0,0
1058,22.46557,113.883376,0,6,6
1059,22.646368,114.13591,7,0,7
1060,22.773105,113.814433,24,0,24
1061,22.641373,114.014713,0,12,12
1062,22.535761,114.057758,0,3,3
1063,22.577544,114.121201,87,0,87
1064,22.530817,113.912693,0,8,8
1065,22.534817,114.058419,0,6,6
1066,22.499241,113.93911,0,12,12
1067,22.629079,114.024916,0,6,6
1068,22.720749,114.268913,0,15,15
1069,22.610624,114.129753,0,6,6
1070,22.596059,114.053192,0,12,12
1071,22.543569,114.114493,0,32,32
1072,22.640442,114.009102,0,61,61
1073,22.534218,114.062451,0,28,28
1074,22.520275,113.929574,0,9,9
1075,22.583775,114.259875,2,0,2
1076,22.611685,113.854665,0,13,13
1077,22.511704,113.924145,0,32,32
1078,22.501351,113.939111,0,12,12
1079,22.582072,113.927825,0,11,11
1080,22.647403,114.20466,4,38,42
1081,22.53656,113.998139,0,3,3
1082,22.76682,114.305042,0,47,47
1083,22.623125,114.080907,6,0,6
1084,22.59265,114.000504,0,41,41
1085,22.523311,113.924111,0,18,18
1086,22.641907,113.834711,0,46,46
1087,22.526603,113.944227,0,12,12
1088,22.733921,113.816985,4,77,81
1089,22.721038,113.833747,0,10,10
1090,22.695302,114.056841,0,30,30
1091,22.612175,113.856007,0,13,13
1092,22.546191,113.947256,0,41,41
1093,22.690969,114.064348,0,3,3
1094,22.690363,114.0665,0,3,3
1095,22.597133,114.044574,0,5,5
1096,22.505615,114.059014,0,12,12
1097,22.722982,114.274132,0,16,16
1098,22.551725,114.097493,0,6,6
1099,22.728334,114.278025,0,6,6
1100,22.577798,114.127926,0,4,4
1101,22.594503,114.107556,0,6,6
1102,22.536688,114.115531,0,6,6
1103,22.524166,114.063747,0,12,12
1104,22.493366,113.931223,0,6,6
1105,22.599071,114.310679,0,6,6
1106,22.549722,113.888342,0,2,2
1107,22.603162,114.043763,0,12,12
1108,22.562451,114.137335,0,6,6
1109,22.54791,114.047092,0,6,6
1110,22.658889,114.019749,0,6,6
1111,22.613633,114.117329,0,24,24
1112,22.531456,113.911335,0,12,12
1113,22.737778,114.245841,0,6,6
1114,22.624973,114.130425,0,6,6
1115,22.737977,113.816457,0,10,10
1116,22.498206,113.895179,0,2,2
1117,22.514157,113.919848,0,4,4
1118,22.583215,114.122822,0,5,5
1119,22.58203,113.960152,0,3,3
1120,22.721936,114.234041,0,15,15
1121,22.58963,114.109765,0,4,4
1122,22.535984,114.087581,0,6,6
1123,22.605921,114.043558,0,6,6
1124,22.550273,114.127111,0,6,6
1125,22.738856,113.991112,0,2,2
1126,22.747566,113.806362,0,6,6
1127,22.720163,114.221052,0,3,3
1128,22.629543,114.021293,0,17,17
1129,22.703845,114.220384,0,10,10
1130,22.632913,114.026362,0,4,4
1131,22.645413,114.209028,0,6,6
1132,22.570501,114.036761,0,6,6
1133,22.531691,114.024208,0,8,8
1134,22.694073,114.042589,0,9,9
1135,22.578733,113.868922,0,4,4
1136,22.529977,114.021484,0,20,20
1137,22.532642,113.911597,0,3,3
1138,22.538244,113.919175,0,2,2
1139,22.581589,113.946877,0,4,4
1140,22.513089,113.928222,0,3,3
1141,22.548142,114.150944,0,2,2
1142,22.534075,114.019945,0,10,10
1143,22.525033,114.056,0,3,3
1144,22.591877,114.125263,0,2,2
1145,22.553471,113.973854,0,18,18
1146,22.711042,114.208544,0,12,12
1147,22.613197,114.072736,0,12,12
1148,22.729017,114.268374,0,15,15
1149,22.52257,114.053016,0,2,2
1150,22.609421,113.855772,0,34,34
1151,22.595913,114.303353,0,8,8
1152,22.523942,114.044504,0,2,2
1153,22.737384,114.250392,0,21,21
1154,22.546132,113.978132,0,15,15
1155,22.724369,114.233794,0,2,2
1156,22.557084,114.033635,0,3,3
1157,22.722642,114.217557,0,3,3
1158,22.51264,113.924036,0,19,19
1159,22.52246,113.950976,0,33,33
1160,22.494838,113.942028,0,6,6
1161,22.479237,113.932763,0,36,36
1162,22.708338,114.344313,0,3,3
1163,22.591236,114.257202,0,12,12
1164,22.612841,114.071079,0,17,17
1165,22.723698,114.256738,0,25,25
1166,22.53638,114.091014,0,3,3
1167,22.713534,114.243293,0,12,12
1168,22.55487,114.238067,0,24,24
1169,22.624271,114.067467,0,12,12
1170,22.718253,114.253704,0,13,13
1171,22.535182,113.987595,0,2,2
1172,22.601418,113.860658,0,26,26
1173,22.521438,114.064556,0,3,3
1174,22.657107,114.035692,0,8,8
1175,22.721148,114.231064,0,12,12
1176,22.62608,114.137048,0,10,10
1177,22.638566,114.032189,0,6,6
1178,22.549984,113.929134,0,3,3
1179,22.576463,113.892121,0,6,6
1180,22.627125,114.027743,0,30,30
1181,22.617098,114.139536,0,18,18
1182,22.684618,114.338572,0,36,36
1183,22.554965,113.873174,0,6,6
1184,22.534946,114.031302,0,6,6
1185,22.513684,113.920863,0,4,4
1186,22.587754,114.124021,0,6,6
1187,22.550343,114.121143,0,4,4
1188,22.651252,114.11246,0,6,6
1189,22.510273,114.05995,0,10,10
1190,22.566642,114.132647,0,4,4
1191,22.538149,114.125288,0,5,5
1192,22.535133,114.107729,0,5,5
1193,22.69996,114.316163,0,12,12
1194,22.625585,114.188201,0,16,16
1195,22.752012,113.8273,0,8,8
1196,22.722822,114.221625,0,6,6
1197,22.618818,113.868041,0,36,36
1198,22.675134,114.048141,0,12,12
1199,22.647552,114.185968,0,12,12
1200,22.634927,113.834988,0,18,18
1201,22.588823,114.251971,0,12,12
1202,22.54017,114.088638,0,6,6
1203,22.704461,114.372497,0,14,14
1204,22.723155,114.221192,0,4,4
1205,22.595404,114.112605,0,12,12
1206,22.547235,113.98761,0,12,12
1207,22.71066,114.256999,0,12,12
1208,22.559674,113.952006,0,12,12
1209,22.642531,114.019401,0,32,32
1210,22.721363,114.045968,0,10,10
1211,22.768149,113.950002,0,12,12
1212,22.720387,114.223935,0,7,7
1213,22.524753,114.066985,0,12,12
1214,22.772847,113.823095,0,12,12
1215,22.664938,114.021476,0,12,12
1216,22.582368,113.872897,0,10,10
1217,22.702422,114.251822,0,12,12
1218,22.528218,113.964945,0,18,18
1219,22.526955,113.951557,0,7,7
1220,22.518393,113.923038,0,4,4
1221,22.735808,114.026818,0,12,12
1222,22.735241,113.994911,0,12,12
1223,22.532492,114.026874,0,4,4
1224,22.523979,114.067134,0,4,4
1225,22.561607,113.980837,0,5,5
1226,22.623967,114.141152,0,12,12
1227,22.55229,114.130084,0,9,9
1228,22.504121,114.058674,0,2,2
1229,22.529828,114.024085,0,13,13
1230,22.515192,114.061731,0,2,2
1231,22.527438,113.923885,0,4,4
1232,22.533842,114.058097,0,3,3
1233,22.766131,113.853058,0,12,12
1234,22.529755,114.023596,0,6,6
1235,22.514032,114.056014,0,3,3
1236,22.644377,114.180101,0,4,4
1237,22.614995,114.069997,0,1,1
1238,22.77499,113.813599,0,6,6
1239,22.611368,114.059344,0,0,0
1240,22.569027,113.952747,0,2,2
1241,22.607674,114.146835,0,6,6
1242,22.645413,114.209028,0,0,0
1243,22.613197,114.072736,0,0,0
1244,22.772847,113.823095,0,0,0
1245,22.542639,114.122837,0,60,60
1246,22.627558,114.031098,2,10,12
1247,22.730455,113.892555,24,0,24
1248,22.583094,113.862667,0,8,8
1249,22.567589,113.866441,0,41,41
1250,22.563381,113.895929,12,0,12
1251,22.665218,114.294651,5,0,5
1252,22.695126,113.97071,0,9,9
1253,22.7259,113.785002,0,22,22
1254,22.665233,114.294972,7,0,7
1255,22.572367,113.86248,0,13,13
1256,22.584374,113.91395,30,0,30
1257,22.58015,113.88261,40,0,40
1258,22.672488,113.827284,6,9,15
1259,22.76682,114.305042,0,48,48
1260,22.571329,114.081942,0,0,0
1261,22.700743,114.040714,0,0,0
1262,22.571329,114.081942,24,484,508
1263,22.700743,114.040714,0,171,171
1264,22.596108,113.837475,6,2,8
1265,22.58233,113.87297,0,7,7
1266,22.707962,114.050993,0,6,6
1267,22.768992,113.904372,32,0,32
1268,22.720581,113.830914,5,5,10
1269,22.664709,114.060621,16,0,16
1270,22.728282,113.82838,0,12,12
1271,22.773105,113.814433,38,0,38
1272,22.667844,114.028159,40,0,40
1273,22.531951,113.91798,0,12,12
1274,22.535743,114.056493,0,26,26
1275,22.530724,113.946999,0,10,10
1276,22.70772,113.81544,78,0,78
1277,22.669546,114.22421,0,10,10
1278,22.563818,113.872893,0,18,18
1279,22.709425,114.345528,0,35,35
1280,22.587332,113.965995,0,23,23
1281,22.589161,113.894683,0,9,9
1282,22.537611,114.026597,0,18,18
1283,22.71103,114.352429,38,0,38
1284,22.712667,114.248656,44,0,44
1285,22.720385,114.268467,0,33,33
1286,22.533349,114.03006,0,12,12
1287,22.530696,114.032022,0,18,18
1288,22.546939,114.059874,0,23,23
1289,22.707919,114.100896,0,1,1
1290,22.611119,113.855179,0,13,13
1291,22.554594,113.920728,0,35,35
1292,22.681539,114.135157,4,55,59
1293,22.602568,113.846998,0,9,9
1294,22.668147,113.813758,0,10,10
1295,22.536144,113.953061,0,14,14
1296,22.639484,114.407893,0,111,111
1297,22.616327,114.073839,0,12,12
1298,22.57424,113.84918,0,10,10
1299,22.542691,114.06504,0,7,7
1300,22.541942,114.1484,0,6,6
1301,22.505508,113.92893,0,16,16
1302,22.720042,114.236146,0,6,6
1303,22.567775,114.101647,0,4,4
1304,22.601194,114.307942,0,6,6
1305,22.540539,114.108547,0,6,6
1306,22.742955,114.238233,0,24,24
1307,22.722374,114.270027,0,3,3
1308,22.567143,114.060394,0,4,4
1309,22.58871,113.965933,0,12,12
1310,22.545241,114.105277,0,6,6
1311,22.573683,113.917463,0,6,6
1312,22.681133,114.327669,0,48,48
1313,22.554161,114.105736,0,8,8
1314,22.60667,114.370015,0,11,11
1315,22.591227,114.111163,0,6,6
1316,22.551326,114.093001,0,6,6
1317,22.551826,114.02327,0,25,25
1318,22.540639,113.939946,0,12,12
1319,22.721584,114.30272,0,72,72
1320,22.689785,113.802875,0,12,12
1321,22.567009,114.044307,0,6,6
1322,22.518234,113.9135,0,7,7
1323,22.54934,113.972743,0,18,18
1324,22.550506,114.148179,0,4,4
1325,22.514319,113.910139,0,12,12
1326,22.541131,113.949093,0,18,18
1327,22.550237,114.125015,0,6,6
1328,22.546952,113.956657,0,6,6
1329,22.517326,113.918524,0,6,6
1330,22.65901,114.034562,0,6,6
1331,22.631418,114.062839,0,6,6
1332,22.636336,114.226114,0,6,6
1333,22.54549,113.929001,0,6,6
1334,22.532804,114.086178,0,4,4
1335,22.765746,113.88807,0,12,12
1336,22.541915,114.048537,0,11,11
1337,22.697634,114.129661,0,10,10
1338,22.527085,114.044711,0,2,2
1339,22.598809,114.128861,0,15,15
1340,22.558398,114.103192,0,6,6
1341,22.515114,113.915048,0,9,9
1342,22.572312,114.067697,0,3,3
1343,22.564367,114.101861,0,9,9
1344,22.530345,114.023725,0,24,24
1345,22.725342,114.23415,0,2,2
1346,22.642507,114.195989,0,20,20
1347,22.509271,114.054217,0,3,3
1348,22.526718,114.057327,0,3,3
1349,22.677294,114.228889,0,13,13
1350,22.542538,114.15406,0,4,4
1351,22.722061,114.234642,0,5,5
1352,22.6314,114.022126,0,6,6
1353,22.573115,114.126998,0,12,12
1354,22.527513,113.921713,0,1,1
1355,22.734261,114.234052,0,30,30
1356,22.723968,114.237461,0,7,7
1357,22.569655,113.960901,0,2,2
1358,22.51861,114.059622,0,11,11
1359,22.563311,113.891401,0,6,6
1360,22.563993,114.139728,0,5,5
1361,22.659121,114.037064,0,3,3
1362,22.567721,113.85752,0,3,3
1363,22.548838,113.976176,0,19,19
1364,22.61815,114.071013,0,28,28
1365,22.593046,114.127911,0,3,3
1366,22.626858,113.938413,0,5,5
1367,22.557666,114.22728,0,3,3
1368,22.703166,114.36632,0,43,43
1369,22.525856,114.040114,0,1,1
1370,22.538933,114.066654,0,3,3
1371,22.68336,114.261518,0,18,18
1372,22.732434,113.814009,0,12,12
1373,22.56248,114.016557,0,8,8
1374,22.625511,114.140877,0,25,25
1375,22.653237,114.021369,0,5,5
1376,22.551414,114.23509,0,6,6
1377,22.633042,114.080989,0,6,6
1378,22.549683,114.109398,0,6,6
1379,22.617325,114.07417,0,58,58
1380,22.632167,114.03111,0,10,10
1381,22.614035,114.125901,0,12,12
1382,22.532962,113.917544,0,15,15
1383,22.506347,114.04727,0,4,4
1384,22.548148,114.119307,0,6,6
1385,22.635268,114.021862,0,45,45
1386,22.541484,113.944887,0,6,6
1387,22.540577,114.107969,0,2,2
1388,22.510387,113.904779,0,24,24
1389,22.585026,114.119249,0,12,12
1390,22.569354,114.055945,0,10,10
1391,22.732842,113.991746,0,6,6
1392,22.610124,114.041581,0,6,6
1393,22.518818,114.049625,0,1,1
1394,22.750858,114.279129,0,12,12
1395,22.55723,113.876173,0,18,18
1396,22.766258,113.883162,0,12,12
1397,22.540041,114.126695,0,12,12
1398,22.543637,114.066576,0,30,30
1399,22.493997,113.920825,0,6,6
1400,22.695284,114.140841,0,12,12
1401,22.613352,113.858483,0,6,6
1402,22.571428,114.046272,0,6,6
1403,22.776858,113.910772,0,4,4
1404,22.593903,114.110969,0,10,10
1405,22.546191,114.045764,0,2,2
1406,22.709987,114.243036,0,30,30
1407,22.578202,113.893979,0,12,12
1408,22.649372,114.020444,0,10,10
1409,22.498369,113.892007,0,16,16
1410,22.522972,114.06583,0,12,12
1411,22.5945,114.113153,0,12,12
1412,22.541107,114.018025,0,16,16
1413,22.573943,113.877687,0,12,12
1414,22.526755,114.052991,0,12,12
1415,22.582289,113.889006,0,12,12
1416,22.619325,114.156293,0,12,12
1417,22.709621,114.239578,0,12,12
1418,22.533784,113.922847,0,3,3
1419,22.627845,114.419455,0,12,12
1420,22.550654,114.230023,0,12,12
1421,22.565137,114.181964,0,18,18
1422,22.739608,113.992113,0,12,12
1423,22.532151,114.064015,0,10,10
1424,22.722749,114.23616,0,1,1
1425,22.524048,113.915393,0,1,1
1426,22.518753,114.03502,0,1,1
1427,22.519846,113.92279,0,2,2
1428,22.531661,114.033277,0,3,3
1429,22.514224,114.062703,0,4,4
1430,22.508878,114.057356,0,2,2
1431,22.643895,114.178635,0,6,6
1432,22.512717,113.931863,0,6,6
1433,22.709421,114.242872,0,3,3
1434,22.700405,114.231005,0,5,5
1435,22.659176,114.040146,0,8,8
1436,22.51103,114.061647,0,18,18
1437,22.720287,114.233132,0,12,12
1438,22.59271,114.123481,0,1,1
1439,22.646553,114.178269,0,18,18
1440,22.569782,114.056773,0,10,10
1441,22.564041,114.059951,0,6,6
1442,22.534251,114.057063,0,4,4
1443,22.692928,114.227573,0,6,6
1444,22.560364,113.934828,0,3,3
1445,22.634511,114.078839,0,6,6
1446,22.560468,113.877582,0,12,12
1447,22.540945,113.95232,0,2,2
1448,22.515924,114.074193,0,6,6
1449,22.597976,114.127726,0,12,12
1450,22.534342,114.115226,0,8,8
1451,22.703162,114.227929,0,12,12
1452,22.58871,113.965933,0,0,0
1453,22.54549,113.929001,0,0,0
1454,22.642507,114.195989,0,0,0
1455,22.573943,113.877687,0,0,0
1456,22.5945,114.113153,0,0,0
1457,22.596108,113.837475,0,0,0
1458,22.669049,114.038511,0,9,9
1459,22.673562,113.806076,0,22,22
1460,22.570953,113.859444,0,18,18
1461,22.562183,114.103032,0,10,10
1462,22.714121,113.784724,0,20,20
1463,22.582831,113.858895,0,36,36
1464,22.747521,114.021307,0,10,10
1465,22.484426,113.89343,0,22,22
1466,22.69064,113.993783,2,16,18
1467,22.57424,113.84918,0,38,38
1468,22.707919,114.100896,0,1,1
1469,22.606571,113.936386,24,8,32
1470,22.563403,113.896238,4,22,26
1471,22.707919,114.100896,0,0,0
1472,22.541207,113.968027,0,6,6
1473,22.723239,114.045873,0,12,12
1474,22.502405,114.058368,4,0,4
1475,22.637597,113.842287,0,18,18
1476,22.584301,114.259926,0,12,12
1477,22.648509,114.188444,0,6,6
1478,22.605313,114.035096,34,0,34
1479,22.536856,114.119823,0,1,1
1480,22.734406,113.888679,0,9,9
1481,22.602618,114.149414,6,0,6
1482,22.497826,113.892681,0,20,20
1483,22.533926,114.493513,0,10,10
1484,22.710536,114.208851,0,18,18
1485,22.526115,113.930444,0,6,6
1486,22.544466,113.935979,0,76,76
1487,22.713154,114.026166,58,0,58
1488,22.572635,113.848326,0,42,42
1489,22.636284,114.185368,3,32,35
1490,22.542201,113.932805,0,41,41
1491,22.682527,113.831075,0,29,29
1492,22.505326,113.92807,0,18,18
1493,22.616438,114.106996,0,17,17
1494,22.514911,113.925543,8,65,73
1495,22.720036,114.237543,0,6,6
1496,22.662953,113.892261,68,0,68
1497,22.545938,113.935285,0,23,23
1498,22.53707,113.953522,0,71,71
1499,22.538803,114.019816,9,0,9
1500,22.605773,113.838491,0,98,98
1501,22.670646,114.051511,8,0,8
1502,22.723239,114.045873,15,0,15
1503,22.716504,114.257083,0,9,9
1504,22.611978,113.855971,0,13,13
1505,22.72878,114.25332,0,10,10
1506,22.681845,114.121224,0,11,11
1507,22.7172,114.240013,0,6,6
1508,22.575293,113.893699,0,13,13
1509,22.603742,114.146513,9,0,9
1510,22.547822,114.110088,0,1,1
1511,22.569144,114.05504,0,18,18
1512,22.663549,113.929314,6,0,6
1513,22.480345,113.915928,0,6,6
1514,22.75975,114.270844,66,0,66
1515,22.545405,113.935049,0,10,10
1516,22.519079,114.033683,0,9,9
1517,22.664085,113.999412,0,3,3
1518,22.55538,114.14202,0,6,6
1519,22.648233,114.022973,0,6,6
1520,22.552862,114.105538,0,5,5
1521,22.766855,113.903382,0,30,30
1522,22.762841,114.278477,0,26,26
1523,22.702903,114.400987,0,36,36
1524,22.545534,114.104934,0,6,6
1525,22.540094,113.919356,0,24,24
1526,22.552652,114.041317,0,6,6
1527,22.587594,113.966093,0,12,12
1528,22.605798,114.143938,0,12,12
1529,22.523102,114.025571,0,12,12
1530,22.592859,114.192009,0,6,6
1531,22.523506,114.02549,0,18,18
1532,22.550737,114.234841,0,6,6
1533,22.509936,113.887706,0,24,24
1534,22.578417,114.126329,0,6,6
1535,22.564484,114.097899,0,7,7
1536,22.725087,114.292425,40,0,40
1537,22.735424,113.816086,0,12,12
1538,22.543792,114.127054,0,2,2
1539,22.57041,114.043545,0,6,6
1540,22.673992,114.32911,0,6,6
1541,22.561583,114.141662,0,6,6
1542,22.561069,114.056394,0,6,6
1543,22.521753,114.066109,0,6,6
1544,22.534084,114.112734,0,8,8
1545,22.569794,113.965021,0,10,10
1546,22.564524,114.045182,0,6,6
1547,22.593517,114.046142,0,6,6
1548,22.716042,114.033861,0,12,12
1549,22.525936,113.954281,0,6,6
1550,22.60076,114.042145,0,12,12
1551,22.541996,114.014366,0,6,6
1552,22.644705,114.021208,0,6,6
1553,22.537577,114.124912,0,6,6
1554,22.702862,114.400048,0,6,6
1555,22.724242,113.832858,0,1,1
1556,22.712094,114.272211,0,10,10
1557,22.722118,114.302573,0,42,42
1558,22.66929,114.040346,0,12,12
1559,22.549168,114.014498,0,6,6
1560,22.555249,114.187484,0,6,6
1561,22.587969,114.259261,0,10,10
1562,22.624926,114.104779,0,12,12
1563,22.542171,114.13733,0,4,4
1564,22.573763,114.06409,0,6,6
1565,22.750283,114.216643,0,18,18
1566,22.547544,114.044548,0,3,3
1567,22.563223,114.051327,0,3,3
1568,22.72649,114.234074,0,3,3
1569,22.561747,113.890616,0,2,2
1570,22.551321,114.044008,0,7,7
1571,22.590903,114.059013,0,6,6
1572,22.554753,113.869808,0,31,31
1573,22.607928,114.12177,0,6,6
1574,22.643016,114.169644,0,11,11
1575,22.553335,113.916163,0,16,16
1576,22.575159,113.869585,0,3,3
1577,22.650378,114.212982,0,36,36
1578,22.549514,114.018197,0,4,4
1579,22.727691,114.225677,0,6,6
1580,22.725587,114.235208,0,2,2
1581,22.630981,114.07694,0,6,6
1582,22.594177,114.123872,0,6,6
1583,22.636802,114.027956,0,12,12
1584,22.647887,114.207009,0,3,3
1585,22.550914,113.967915,0,3,3
1586,22.588945,113.887339,0,12,12
1587,22.607174,113.855288,0,16,16
1588,22.699834,114.237036,0,3,3
1589,22.512397,113.914917,0,6,6
1590,22.552793,113.919052,0,6,6
1591,22.547564,114.229801,0,3,3
1592,22.527708,114.054204,0,18,18
1593,22.64452,114.196447,0,4,4
1594,22.618932,114.149952,0,24,24
1595,22.721403,114.271119,0,6,6
1596,22.61317,114.066001,0,9,9
1597,22.570986,114.12822,0,12,12
1598,22.694639,114.058912,0,6,6
1599,22.771169,113.819783,0,19,19
1600,22.64233,114.070077,0,12,12
1601,22.516818,113.931272,0,12,12
1602,22.555318,114.107819,0,6,6
1603,22.57143,114.065204,0,6,6
1604,22.548873,114.130531,0,6,6
1605,22.535828,114.117989,0,10,10
1606,22.730557,114.253153,0,12,12
1607,22.770918,114.302129,0,10,10
1608,22.722655,114.226411,0,24,24
1609,22.535296,113.995476,0,6,6
1610,22.605216,114.111378,0,12,12
1611,22.720536,114.268533,0,6,6
1612,22.578378,114.136688,0,6,6
1613,22.67163,113.990661,0,6,6
1614,22.625702,114.136194,0,18,18
1615,22.56207,114.129048,0,6,6
1616,22.656069,114.115894,0,12,12
1617,22.560145,113.874326,0,18,18
1618,22.51569,113.911978,0,6,6
1619,22.549065,113.923972,0,12,12
1620,22.751792,113.93798,0,20,20
1621,22.572651,114.110003,0,6,6
1622,22.637503,113.840037,0,12,12
1623,22.63656,113.840979,0,12,12
1624,22.522938,114.065879,0,12,12
1625,22.56042,113.933986,0,12,12
1626,22.651336,114.065799,0,18,18
1627,22.611474,114.104702,0,12,12
1628,22.673337,114.048099,0,22,22
1629,22.563805,114.182055,0,12,12
1630,22.5361,113.981006,0,12,12
1631,22.631653,114.035066,0,36,36
1632,22.709426,114.261891,0,12,12
1633,22.572388,114.060043,0,7,7
1634,22.573538,113.895954,0,24,24
1635,22.624866,114.083356,0,6,6
1636,22.633932,114.024997,0,16,16
1637,22.56701,113.942558,0,8,8
1638,22.49712,113.892546,0,12,12
1639,22.570965,114.090044,0,6,6
1640,22.557413,114.032269,0,4,4
1641,22.581847,113.947264,0,4,4
1642,22.63037,114.016962,0,6,6
1643,22.561911,113.874745,0,18,18
1644,22.552619,114.038114,0,1,1
1645,22.730787,114.244115,0,6,6
1646,22.550893,114.043948,0,3,3
1647,22.621988,114.141997,0,12,12
1648,22.53903,114.095517,0,4,4
1649,22.52414,114.042879,0,1,1
1650,22.736049,113.998884,0,12,12
1651,22.723835,114.235423,0,12,12
1652,22.524364,113.92575,0,24,24
1653,22.584554,113.861715,0,12,12
1654,22.518394,114.067089,0,6,6
1655,22.586247,114.130297,0,4,4
1656,22.636614,114.007994,0,30,30
1657,22.618396,114.059631,0,12,12
1658,22.535963,114.081082,0,6,6
1659,22.626471,114.137096,0,10,10
1660,22.525873,114.043903,0,3,3
1661,22.598395,114.126909,0,8,8
1662,22.588745,113.991005,0,63,63
1663,22.554645,114.043593,0,6,6
1664,22.547198,114.066948,0,6,6
1665,22.53707,113.953522,0,70,70
1666,22.605773,113.838491,0,99,99
1667,22.587594,113.966093,0,0,0
1668,22.650378,114.212982,0,0,0
1669,22.64233,114.070077,0,0,0
1670,22.573538,113.895954,0,0,0
1671,22.524364,113.92575,0,0,0
1672,22.698816,113.791756,6,38,44
1673,22.700154,114.134341,0,10,10
1674,22.53707,113.953522,0,69,69
1675,22.71356,113.853433,50,0,50
1676,22.667192,114.288926,0,15,15
1677,22.665823,114.35166,0,88,88
1678,22.636284,114.185368,3,31,34
1679,22.682527,113.831075,0,0,0
1680,22.564051,113.850125,0,1,1
1681,22.700743,114.040714,0,171,171
1682,22.700743,114.040714,0,0,0
1683,22.544466,113.935979,0,0,0
1684,22.542201,113.932805,0,0,0
1685,22.53332,114.063909,0,12,12
1686,22.487667,113.89208,0,12,12
1687,22.666759,114.022483,6,6,12
1688,22.589744,113.991289,0,12,12
1689,22.607267,114.13163,0,34,34
1690,22.540594,114.109352,0,8,8
1691,22.552091,114.095035,0,12,12
1692,22.573866,114.129702,0,6,6
1693,22.718557,114.217442,0,27,27
1694,22.739581,114.399153,0,21,21
1695,22.768229,113.822971,0,15,15
1696,22.624303,114.103998,0,80,80
1697,22.706446,114.344855,0,3,3
1698,22.658375,114.065838,0,10,10
1699,22.574746,113.941098,0,30,30
1700,22.722859,114.297673,0,30,30
1701,22.531743,114.033293,0,15,15
1702,22.580585,114.143096,0,10,10
1703,22.713874,113.832054,0,12,12
1704,22.572502,113.848038,0,12,12
1705,22.559902,114.109376,0,6,6
1706,22.574746,113.941098,0,0,0
